11111111111111111111111111
10000000000011000000000001
10111011111011011111011101
14111011111011011111011141
10000000000000000000000001
10111011011111111011011101
10000011000011000011000001
11111011111011011111011111
11111011000000000011011111
11111011011122111011011111
30000000011555511000000003
11111011011111111011011111
11111011000000000011011111
11111011011111111011011111
10000000000011000000000001
10111011111011011111011101
14001000000060000000010041
11101011011111111011010111
10000011000011000011000001
10111111111011011111111101
10000000000000000000000001
11111111111111111111111111
